/3333000/
//433443/
333303340
/03003343
333334433
3330333//